Aep - kogoś)
Ann - kręcić
Arainne - krogulec
A’ri - kręcić się (w okolicy)
Bath - kąpiel
Beanna - kobieta
Belleteyn - kwitnienie
Blath - kwiat
Blathan - kwiaty (dopełniacz: „blathanna”)
Bloed - krew
Bloede - krwawy
Boaer - kmiotek
Breinne - królewski
Caer - kraj
Carn - kurhan
Carnnan - katakumby
Ceanndant - komendant
Cerbin - kruk
Corpail’ear - kapral
Cot - kura
Cò - który (jedynie forma twierdząca)
Craag - klif
Creasa - koniecznie
Deireadh - koniec
Deireadh - kończyć
Diùcad - księstwo
Dol - kotlina
Eigean - konieczne
Eisio, aark - kra
Evall - koń
Evall - konny
Eveliien, Evelienn, Evellienn - każdy
Foerann - kraina
Geas - klątwa
Gwyd - klon
Henge - klif
Hoer, hvren - kurwa
Hwone - kiedy
Ichaer - krew (nie w znaczeniu krwi jako takiej
Imbaelk - kiełkowanie
Katte - kot
Katte - kocie
Klu - kolanor
Korps - korpus
Marche, March, Maerch - kobieta
Mar’sande - kupiec
Milva - kania ruda (gatunek ptaka)
Moe'itë - kłopoty
Mol - kret
Morc - książka
Phea - kilka
Prop - knebel
Prionnsa - książe
Que'ess - kto
Que'ess - który
Quess', Ques', Que'ss - kto
Quess', Ques', Que'ss - który
Quess', Ques', Que'ss - który zostaje po nim umieszczony. Zazwyczaj funkcjonuje jako skrócona forma Que esse (Np. Ques’ann  co zrobisz))
Reigmeid - kompania
Rhen - król
Rhena - królowa
Rotsaak - kanalia
Ruit’reigmeid - kawaleria
Ruit’reigmeid - konny
Sheyss - kurwa
Soorkool - kapusta
Voorsnit - kajdanki
Voorsnit - kajdany
Ym’grymie - kłaniać się