A - że, do, od, dla (np. Sàbh a me - piła do mnie, piła dla mnie), rodzajnik nadający okolicznikowi określenie "jak" (np. En’ca land n’ees a evelloë saor. - Małe państwo nie może być w pełni niezależne.), to, angielskie of
A'anval - atak, atakować, zaatakować
Aard - najwyższy, najbardziej
Aarde - ziemia, grunt
A'báeth - pocałunek
Abb - ujście (np. rzeki)
Addan, Adan - tańczyć, tancerz, taniec
Adhart - naprzód, do przodu
Aecáemm - podążać
Aedd - okruch
Aefder - później, po
Aedragh - prowokować, przeszkadzać
Aen'drean - wejść
Aenye - ogień, ognisty
Aegef - podać
Aen - na (np. "Na Wielkie Słońce"), w, rodzajnik nadający rzeczownikowi po nim znaczenie celownika (komu? czemu?), miejscownika (kim? czym?) i biernika (kogo? co?), z (kimś, czymś), do, słowo czasami pełni również funkcję angielskiego the
Aep - w, na, pośród, przed, nad, przez, od, do, z, pod, rodzajnik nadający rzeczownikowi po nim znaczenie dopełniacza (kogo? czego?) i biernika (kogo? co?), po (coś, kogoś)
Aesledde - jazda na sankach
Aespar, spar'le - strzelać, zastrzel, ostrzał
A'ess - być (czas przeszły, trzecia osoba liczby pojedyńczej i mnogiej)
A'essea - byłem, byliśmy, byłyśmy
A'esseath - byłeś, byliście, byłyście
Aëte - lato
Aevon - rzeka
Aine - światło
Ainm, Aymm - imię, nazwa, nazywać się
Aint - pyszny, smaczny
Àite - tutaj (w tym miejscu)
Allaidh - dzikus
Allaidhe - dziki
Als, Alz - gdyby, jak (angielskie when), jeśli, jeżeli, jakby
Altaich - relaks
Am - mieć, za (w zamian), na
An - i, oraz, ale, lecz, z, mały, mniejszy
Anart - ubrania
An'givare - szpieg, informator, donosiciel
Ann - zakręcić, kręcić
Àraich - sprowadzić
Arainne - krogulec
Aran - chleb
Arbaith - zajęcie, działalność, praca
Ard - wysoki, najwyższy, góra, szczyt
Areir - zgodnie
A’ri - kręcić się (w okolicy)
Armach - zbroja
Ar'ne - bo
Ardadel - szlachcic
A-réir - określenie wyolbrzymiający przymiotnik (np. Taka (zacna), Ależ (brutal), Jaki (męski)) ****
Arse - dupa, rzyć
A’taeghane - dzisiaj, teraz
Ath - oczy, widzieć, zobaczyć
Aure - złoto
A'vean - nas, nasz, wasz
Awr - pan
Ax - topór, siekiera
Ayd - nie
Baard - broda
Bainnse - wesele, ślub
Ban - miejscowość
Ban-Diùc - księżna
Bar - ciąć, ucinać, odciąć, urżnąć
Bath - kąpiel
Beag - mało
B'eanshie - zjawa
Beanna - kobieta
Beatha - życie, żyć
Begript - rozumieć, zrozumieć, zrozumiałe
Bèist - bestia, zwierzę
Belean'graec - ważny, ważne, oczekiwany, oczekiwane
Belleteyn - kwitnienie
Beseta - penseta
Bethaalen - zapłata, żołd
Bhampair - wampir, wampiry
Birke - równonoc wiosenna
Blàr - pole
Blas - smakować, smak
Blath - kwiat
Blathan - girlanda, kwiaty (dopełniacz: „blathanna”)
Bleidd - wilk
Bloed - krew
Bloede - cholerny, pieprzony, krwawy
Boaer - kmiotek
Bomaeb - bomba
Brath - wiedzieć (o czymś)
Bràtheir - brat
Breinne - królewski
Breuk - złamać
Broggha, Breoga - żabka, żaba
Brokiloéne - z Brokilonu
Brùi - brutal
Bu'rac - prostak, dureń
Cas - noga
Caed - las, gaj
Caedva - puszcza
Caelm - spokój, spokojny, cichy, powoli, cicho, spokojnie, uspokajać się
Caemm, Cáemm - iść, przyjść
Caen - móc, można
Caente - dzień
Caer - twierdza, warownia, dom, kraj
Caer’den - dwór
Cáerme - los, przeznaczenie
Caisse - ściągnąć, przywieść, dostarczyć, przynieść (ang. bring)
Cairt - powierzchnia
Caith - zrzucić (zdjąć, rozebrać)
Camraid - towarzysz
Carbad - wóz
Carn - kurhan, dół, doły, grób, grobowiec
Carnnan - katakumby
Cassve - Biorąc pod uwagę, zważywszy na
Carraigh - skała
Ceádmil - witaj
Ceadmill - witajcie
Cea'dsaa - rozpusta
Ceanndant - komendant, dowódca
Ceann - głowa, głownia, głowica, łeb
Ceap - tani, tanie
Ceas'raet - imperium, cesarstwo
Ceath - cztery
Celfyd - sztuka
Cerbin - kruk
Ceòlh - muzyka
Cinerea - Żyrytwa
Claidheamh - schować
Clytie - grządki
Cnàmhan - stały, ciągły
Coeden - las
Cofhurtail - wygodnie
Col - przełęcz
Colled - strata, straty
Coltais - podobno, ponoć
Còmhrag - front
Conyn - łodyga
Coram - lew
Corpail’ear - kapral
Corras - serce
Cot - kura
Cò - który (jedynie forma twierdząca)
Craag - skała, klif
Creasa - koniecznie, powinność, nieuchronnie, obowiązkowo, trzeba, musieć
Creide - wierzyć (komuś)
Crevan - lis
Croigh - wieszać, powiesić
Cruinn - pierścień
Cuan - prostytutka
Cuir - zatrzymywać się, zakładać
Daerienn - czarodziejka, magiczka
Daetre - tył
Dal - grupować, zgrupować
Dana - panna
Darganfod - odkrycie, odkrywać, odkrywca
Darl'len - czytać
Dat - żeby, aby
Deaghlach - rodzina
Dear - rodzajnik, podłączany do wyrazu z myślnikiem, określający, iż coś jest takie same lub też to same (np. dear-ceòlh - taka sama muzyka; dear-zaighde’r - tan sam żołnierz)
Dearf - pewność
Dearg - czerwony
Dearme - żegnaj, śpij, spać, dobranoc
Dei'bai, de'bai - zatoka
Deich - dziesięć
Deien - służyć
Deinyg - utuczyć się, spuchnąć (stać się grubym)
Deireadh - koniec, kończyć, ostateczny
Deith - płomień
Deithe - podpalać
Dhearmad - zapomnieć
Dh'oine - człowiek, ludzie
Dhu - czarny, ciemny
Dhut - szczęście
Dice - mówić, gadać
Dicen - mowa, dialekt
Dicette - opowiadać, powtarzać
Dielch - dziękuję
Difranh - inaczej, inny, dziwny
Diùcad - księstwo
Divedde - stawaj (do walki)
Dòchas - nadzieja
Dòirt - rozlewany
Dol - dolina, kotlina, dołek
Dolmaach - zachowanie
Doo - rów, dół
Draes - suknia, sukienka
Draga - nosić
Drieschot - trójkąt
Droog - osuszać, szuszyć
Drùis-dhai - burdel
Du - go, jego
Duges - diuszesa
Dure - podczas
Dùth - właściwy
Dwimeritium - dwimeryt
Dyaebl, D'yaebl - diabeł, czart
Eabarë - rozmokły
Earala - ostrzegać
Eate - rok
Eate'n - lata
E'er - cześć (honor)
Eigean - konieczne, wymagane, musieć
Eimyr - jeż
Eisio, aark - kra
Elaine - piękny
Elle - olcha
Ell'ea - dobrze, w porządku, świetnie (słowo rzadko używane w dialekcie nilfgaardzkim, w dialekcie skelligijskim stosowane również jako pytanie (np. Va'en aesledde, ell'ea? - Pójdziemy na sanki, dobrze?). W oryginalnej Starszej Mowie konstrukcja ta jest poprawna, jednak uchodzi za niegrzeczną.)
Eluaim - dźwięk
En'ca - mały, małe, malutki
Enect - uchwalać
Enid - stokrotka
Enn'le - brać go
Ennv - łatwo
Ensh'eass - czarujące, fascynujące, urocze, efektowne
Erkene - rozpoznać, znać, poznać, znać się
Es - że
Esan - on, go, jego
Ess - być (trzecia forma osobowa, czas teraźniejszy), mieć, a także on, ona, ono (podobnie do angielskiego it's)
Esse - być (czas przyszły), mieć (czas przyszły), a także oni, one (podobne do angielskiego they, they're)
Essea - jestem, jesteśmy, mam, mamy
Esseath - jesteś, jesteście, masz, macie
Eveigh - zawsze
Evall - koń, wierzchowiec
Evall - konny, jeździec
Eveliien, Evelienn, Evellienn - wszyscy, każdy, wszystko
Evell - cały
Evell’caer - świat, cały świat
Evelloë - w pełni, całkowicie
Evgyr - teraz, stać
Externe - na zewnątrz
Fachne - siostra
Faight - znaleźć
Fàile - stęchły (śmierdzący)
Faill - znowu, ponownie
Fairich - czuć się
Fallain - zdrowie, zdrowy
Fathair - ojciec
Feain - słońce
Feansa - płot
Fear - daleko
Feer - lepiej
Feldwebel - feldfebel (sierżant)
Fem - pięć
Fen - bagna, mokradła
Fion - wino
Fireann - męski, męstwo
Fir’inn - prawda
Fògair - pogonić, odrzucić (kogoś od czegoś), wyrzucić
Foghnè - rodzaj, typ
Foilé, Foile - szalony, wściekły
Fors - wodospad[1]
Foerann - kraina, region
Fraer - brat
Fydd - przełęcz
Gaeth - potral, wrota
Gàidh, Gàrracaer, Gardd - ogród
Galle - prędkość
Garantie - szansa, gwarancja, pewno
Gàrd - wartownik, strażnik
Gàrdan - straż
Garddvrae - ogrodnictwo
Gar'ean, Garean - uważaj, uwaga, uważać
Geas - przekleństwo, klątwa, zew
Gedréog - trzeźwy
Geehaet - trudny
Ge’erill - partyzant
Gerookte - wędzony
Ghele - lodowiec[1]
Glaeddyv - miecz, broń
Glaenne - upiększać, doprowadzać do porządku (sprzątać)
Glaes - siny
Glean - dolny, niski
Gleanna - dolina
Glòir - chwała
Glossae, glosse - patrzeć, szukać
Glys - rzeka
Go'deff - ból
Gugac - bąbel
Gràin - nienawidzić, nienawiść
Grìffean - gryf (słowo nie posiada liczby mnogiej)
Gvaedyn - hardy, uparty
Gvasse - wystarczająco
Gvaren - mistrzyni
Gvobr - nagroda
Gvybode - informacja, informacje
Gwinoedd - elfie wino
Gwyd - klon, jawor
Gwyn, Gwynn, Gwen - biały, siwy (Gwen w przypadku, gdy stosuje się nazwę własną, a słowo łączy się z opisywanym rzeczownikiem.) (W języku nilfgaardzkim stosuje się również formę Wen)
Gwynt - wiatr
Gvalch'ca - Falka, sokolica
Gynvael - lód
Haar - włosy
H’acras - głód
Hael - pozdrowienie, zdrowie, pozdrawiam, niech żyje
Haearn - żelazo, żelazny
Hama - szynka, wędlina
Hàr - brzeg (forma używana głównie w języku nilfgaardzkim)
Hav'caaren - nieprzetłumaczalne słowo kojarzące się z drapieżną chciwością; havekarzy
Hav - złe (Aard'hav - najgorsze)
Havfrue - syrena (brak liczby mnogiej)
Heamh - sążeń
Heàrrlois - słychać, słyszeć
Heer - pan (forma grzecznościowa), tu
Heet - gorączka
Hen - stary, starszy
Henge - klif[1]
Herba - ziele
Her’zaer. Ker'zaer - cesarz
Hefyd - także, też
Hevang - jeniec
Hoael - zadupie
Hoal, Hoel - dziura, potocznie: dupa
Hoer, hvren - kurwa, prostytutka, dziwka
Hoog - głębokość
Hvandr - stu
Hvandre - sto
Hwer, hwre - gdzie, gdzieś, tu
Hwone - kiedy, wtedy
Hyn - ten, to
Iare - chcieć, szukać, znaleźć, prosić
Iarean - poszukiwania
Iarla - hrabia
Ichaer - krew (nie w znaczeniu krwi jako takiej, a w znaczeniu więzów krwi)
Il'edrith - zaklęcie, czar, magia
Il'edrithe - czarodziej, mag
Imbael - płodzić, zapładniać
Imbaelk - kiełkowanie
Impireachd - cesarstwo, imperium
Inis - wyspa
Innleadair - inżynier, inżynieryjny
Inváerne - zima
Iom'tha - nieodpowiedni
Ionndrainn - tęsknić, tęsknota
Ismear - pijany, pijaństwo, pijak
Iss'kund - lekarstwo, leczyć, medycyna
Ith - jeść
Ithean - jedzenie (forma w liczbie mnogiej, tak jak w języku polskim, słowo nie posiada liczby pojedynczej)
Jakkten - polowanie, polować, łowy
Jinearalt - generał
Joc - żart, dowcip
Kamndant - dowódca
Kamp - obóz
Katte - kot, kocie
Klaar - osadnik
Klipa - skała
Klu - kolanor
Korps - korpus
Krach - rozbić się, rozbijać się
Kraihen - otrzymać, dostać
Kroofeir - stóg siana
Kusse - genitalia
Lager - niżej, nisko
Laith - dama
Lamh - wziąść na ręce, podnieść
Lammas - dojrzewanie
Land - terytorium, teren, państwo
Lara - mewa
Larwm - alarm, pomoc, wsparcie
Lath - rozluźniać
Lazare - lazaret
Leeg - pusty
Leig - noga
Leith - taki
Licht - lekki
Lionors - lwica
Llamas - dojrzewający
Llinge - język
Loa'then - nienawiść
Loc - jezioro
Loc'lah - Pani Jeziora
Lòn - żarcie
Luath - wkrótce
Luith - obwieś
Luned - dziewczyna, córka
Lyrien - Liryjczyk
Ma - może
Mar - jak (np. Essea stob hwer mar bodan. - Sterczymy tu niczym kuśki.), niczym
Marca - jeździć (konno)
Marche, March, Maerch - kobieta, dziewczyna (słowo stosowane głównie w dialekcie nilfgaardzkim, w klasycznej Starszej Mowie używane rzadko) (słowo nie posiada liczby mnogiej)
Marv - umrzeć, nie żyć
Mass - dno
Math - dobrze, świetnie (słowo stosowane głównie w dialekcie nilfgaardzkim, w klasycznej Starszej Mowie używane rzadko)
Mawr - umierać
Mar’sande - kupiec
Me - ja, mój, mnie
Méadbh (przypuszczalny źródłosłów: ang. meadow, staroangielski mædwe) - polny
Meadhan - środek (centrum)
Meal - winszować
Mear'ya - Maria
Meáth - spotkać, spotkanie
Mëot - mieć (oprócz standardowego znaczenia mieć - posiadać coś, słowo to oznacza również konieczność do zrobienia czegoś, do bycia jakimś. (Przypomina to angielskie have to i działa na podobnej zasadzie. (np. Essea mëot va - Muszę iść/I have to go)))
Meve - środek (wnętrze), w środku (wewnątrz)
Mid - przesilenie
Midaëte - letnie przesilenie
Midinváerne - zimowe przesilenie
Milva - kania ruda (gatunek ptaka)
Minne - miłość
Mire - zobaczyć, patrzeć, patrz
Misneach - fantazja
Mistle - jemiołuszka, paszkot (gatunek ptaka)
Modron, Moedron - mama, matka
Moe'itë - kłopoty
Moeras - bagno, bagna
Mol - kret
Mòran - dużo
Morc - książka, tom
Mori Rígain - Morrigan
Morvud - wróg
Morvudd - wrogowie
Muire - morze
Mynyde - góry
Na - albo, lub
Naev'de - dziewięć
Nag - odgryźć, gryźć
Namyn - poza, oprócz, z wyjątkiem
Ne - ani (podobne do angielskich neither i nor; N'ees behéth ne bhampair ne mallaich! - Nie pisałem się ani na wampiry ani na klątwy)
Neen, Neén, N'een, - nie, ani, bez, nic
Neenphàir - neutralny, bezstronny
N'elaine - nieładnie, nieładny, brzydki
Nell'ea - niedobrze, żle
N’evellien - nikt
Nhetwerk - sieć, sieci (rybackie)
Nílfe - mgła[1]
Niss - pochwa (na broń)
Nor - wystarczy, starczy
Nord - północ
Nordling - Nordling, mieszkaniec Północy
Notach - interes, interesować się
N'te - nie rób (czegoś)
Nyald - igła
Onbekend - nieznany
On'gaan - wypuścić
Órdan - porządek
Orde - rozkaz, życzenie, polecenie
Òrde-zreth - formacja
Orloog - wojna
Ortha - czarować, rzucać uroki
Oost - wschód
Pa’as - zadbać
Palle - siennik
Pavienn - małpa
Pest - choroba, zaraza, plaga, zły urok
Pesta - zachorować, chorować
Pestaë - chory, zarażony
Phea - kilka
Pheòr - ciekawe
Pherian - niziołek
Phoilitigeac - polityk, polityk, polityczny
Piemelikkers - skurwysyny
Plasse - pałac
Pont - most
Prìson - więzień
Prop - knebel
Pràbar - hołota, tłuszcza
Prionnsa - książe
Pump - pompować, pompki
Pund - rzygać, wymiotować
Qinnte - z pewnością, na pewno
Que, Que'ss - czym, co, czego
Que’cail - jak
Que'ess - ile, jak, kto, który
Quess', Ques', Que'ss - co, ile, jak, kto, który, czym, czego (w odniesieniu do czasownika, który zostaje po nim umieszczony. Zazwyczaj funkcjonuje jako skrócona forma Que esse (Np. Ques’ann - co zrobisz)
Raadslid - rajca
Raenn - biegać
Raesce - niecnota
Ragah - zarośnięty
Ragha - wybór
Ràno - ranny
Ratreut - wycofywać się, odwrót
Rechta - wyrok, werdykt
Rechter - sąd
Reic’a - sprzedawać
Reigmeid - kompania, oddział, patrol
Reusanth - rozsądek, rozsądnie
Rhen - król
Rhena - królowa
Rhive - wyznaczać (np. nagrodę)
Rhoin - nadawać (imię, tytuł)
Ro - zanim, nim, przed tym jak
Roethai - Redania
Roethainne - redański
Rotsaak - kanalia
Ruadhri - jeźdźca, jedźcy
Ru'ire - rycerz
Ruit’reigmeid - kawaleria, konny
Sàbh - piła
Sàilre - wypływać, odpływać
Salah - modlić się, módl się
Saoil - dziwić się, zdziwiony
Saor - niezależny
Saov - duch, dusza
Sas - żaden
Savaed - elfi miesiąc, 1/8 roku
Schijtleister - tchórz
Scoia'tael - wiewiórki
Se'ege - zwycięstwo
Sehr - ciężko, ciężki (nie w znaczeniu czegoś, co wiele waży, a raczej w kontekście mocnych odczuć (np. sehr ràno oznacza ciężko ranny, a sehr go'deff - bardzo boli). Gdy chcemy opisać ciężką wagę, stosujemy przymiotnik trom)
Sei’fyll, Seiâ'fyll - szyk, formacja
Seidh - wzgórze (ang. hill)
Seidhe - wzgórzowy
Seo - znaczy, oznacza (Tha seo - to znaczy, że)
Sgalic - pić
Sheyss - kurwa
Shaap - baranina
Sh'aente, Sjunge - śpiewać
Skrekk - szczur
Side - strona (konfliktu)
Sidh - elf, siedzieć
Sigh - ech (westchnienie)
Sinnea - grzech
Skip - statek, okręt
Skool - szkoła
Slaan - dorwać
Slaapcaer - łóżko, alkowa
Slafie - niewolnik (słowo nie posiada liczby mnogiej)
Sledd - sanki
So - że
Sonde - sonda, sondować
Soon - syn
Soond - udany
Soorkool - kapusta
Sor'ca - siostrzyczka
Speath - przepowiednia, wróżba
Ver'spreiden - rozparaszać się, rozprzestrzeniać się
Squaess, Squaesse - przepraszam, przepraszać, wybacz, wybaczać
Ssant - chuć, chutliwy
Stàilinn - stal, stalowy
Stob - sterczeć (siedzieć w jednym miejscu)
Straede - droga, ścieżka, gościniec
Strige - Strzyga
Sychiad - Sprzątać, sprzątanie
Táedh - bard, poeta
Taing - dziękuję, dziękować, podziękowanie (Mòran taing - bardzo dziękuję)
Tanalach - płytko, płytki
Teanga - język
Tearth - strach, bać się
Tedd - czas, wiek, pora, okres, pogoda
Tha - to, oni, ten
Thaë - potem, następnie
Thaess, Thaesse - zamilcz, milcz, zamknij się
Thea - tamta, one
Theenk - myśl, myśleć, pomysł (theenk’a - wymyśleć)
Theervil - póki, dopóki
Tho - twój
Thorp - wieś, wioska
Thu, Te - ty
Tilleadh - wracać, powrót
Tì'lsoë - wierny
Tirth - dzik
Tolla - nuda, znudzenie
Toog - wziąć
Tor - wieża
Torc'h - alszaband
Tre - trzy
Treise - siła, wigor, energia
Tròcair - błagać, błagam
Tro’cayr - litość
Trom - ciężko
Trom'caith - ciężko uzbrojony, ciężkozbrojny
Tu - w
Tunn - miasto
Tùrnment - turniej
Tus - najpierw
Tuveaann - martwica
Tuvean, Tuv'en, Tuve’an - śmierć, zabić
Tuveë - martwy
Twe, tve - dwa
Uniade - związek, pojednanie
Ulf’heid - potwór
Ùisig - używać, wykorzystywać
Va, Ve (forma Ve jest stosowana rzadko i głównie w dialekcie nilfgaardzkim) - iść, spotkać, przyjść, my, wy, zachowywać się
Vae - ruch
Va'en - wycieczka, podróż
Vaer'trouv - zawierzyć, zaufać (komuś)
Vairich - słyszeć
Vall - spaść
Vara - towar
Var'oom - dlaczego, czemu
Vatt’ghern - wiedźmin
Vear'thainn - deszcz
Vedrai - trzymać, zatrzymać
Veldi - bardzo
Velen - równonoc jesienna
Vellienn - razem
Veloë - szybko, szybki
Verdenë - verdeński
Verloos - przegrani, straty
Vermogen - zdolność, możliwości
Versla - zgłaszać się
Visse - poseł, ambasador
Vlagg - flaga
Vlaggeskipa - okręt flagowy
Vluchten - uciekać, uciec
Voe'rle - przestać, zatrzymać
Vooil - brud
Voorsnit - kajdanki, kajdany
Voot - za
Vort - daleko, dalej, jeszcze, wciąż, precz, rzucić
Vraag - słuchać, pytać, pytanie
Vrihedd - wolność
Vrouw - żonaa
Vùtter - woda
Vyos - wiedzieć
Waen - chcieć
Wedd, Weddin - dziecko, dziecię
Wen - biały (uproszczona forma „gwyn” występująca głównie jako sufiks)
Wilde - dziki
Woed, Woéd, Woedd - las, drewno
Wyvern - Wiwerna, Wywerna
Xin'trea - Cintra
Y - i
Yeá - tak
Yea - dobrze (w porządku, świetnie)
Yghern - skolopendromorf
Ym’grymie - pokłoń się, ukłoń się, ukłon, kłaniać się
Ymladda - walka
Yn - a (np. A wiesz, co się stało?), pod, na, i, jeden
Ys - w dół
Ysgarthiad - gówno, cholera
Zaagsel - troociny
Zaighde’r - żołnierz
Zandbanke - łacha (mielizna)
Zèamach - ostrzeżenie
Zeist - problem
Zien - wyglądać
Zireael - jaskółka
Zorgh - przejmować się
Zvaere - przysięgać