Aen'drean - wejść
Aen - w
Aep - w
Ard - wysoki
Ath - widzieć
A'vean - wasz
Bainnse - wesele
Belean'graec - ważny
Belean'graec - ważne
Bhampair - wampir
Bhampair - wampiry
Bleidd - wilk
Brath - wiedzieć (o czymś)
Caer - warownia
Carbad - wóz
Ceádmil - witaj
Ceadmill - witajcie
Cofhurtail - wygodnie
Creide - wierzyć (komuś)
Croigh - wieszać
Dùth - właściwy
Eigean - wymagane
Ell'ea - w porządku
Ell'ea - w dialekcie skelligijskim stosowane również jako pytanie (np. Va'en aesledde
Evall - wierzchowiec
Eveliien, Evelienn, Evellienn - wszyscy
Eveliien, Evelienn, Evellienn - wszystko
Evelloë - w pełni
Fion - wino
Fògair - wyrzucić
Foilé, Foile - wściekły
Fors - wodospad
Gaeth - wrota
Gàrd - wartownik
Gerookte - wędzony
Gvasse - wystarczająco
Gwynt - wiatr
Haar - włosy
Hama - wędlina
Hwone - wtedy
Inis - wyspa
Lamh - wziąść na ręce
Larwm - wsparcie
Luath - wkrótce
Marche, March, Maerch - w klasycznej Starszej Mowie używane rzadko) (słowo nie posiada liczby mnogiej)
Math - w klasycznej Starszej Mowie używane rzadko)
Meal - winszować
Meve - w środku (wewnątrz)
Morvud - wróg
Morvudd - wrogowie
Nor - wystarczy
On'gaan - wypuścić
Orloog - wojna
Oost - wschód
Prìson - więzień
Pund - wymiotować
Ragha - wybór
Ratreut - wycofywać się
Rechta - wyrok
Rechta - werdykt
Rhive - wyznaczać (np. nagrodę)
Sàilre - wypływać
Scoia'tael - wiewiórki
Seidh - wzgórze (ang. hill)
Seidhe - wzgórzowy
Speath - wróżba
Squaess, Squaesse - wybacz
Squaess, Squaesse - wybaczać
Tedd - wiek
Thorp - wieś
Thorp - wioska
Tilleadh - wracać
Tì'lsoë - wierny
Toog - wziąć
Tor - wieża
Treise - wigor
Tu - w
Ùisig - wykorzystywać
Va, Ve (forma Ve jest stosowana rzadko i głównie w dialekcie nilfgaardzkim) - wy
Va'en - wycieczka
Vatt’ghern - wiedźmin
Vort - wciąż
Vrihedd - wolność
Vùtter - woda
Vyos - wiedzieć
Ymladda - walka
Ys - w dół
Zien - wyglądaćWyvern - Wiwerna
Wyvern - Wywerna