A'anval - zaatakować
Aarde - ziemia
Aen - z (kimś
Aep - z
Aespar, spar'le - zastrzel
Am - za (w zamian)
An - z
Ann - zakręcić
Arbaith - zajęcie
Areir - zgodnie
Armach - zbroja
Ath - zobaczyć
Aure - złoto
B'eanshie - zjawa
Begript - zrozumieć
Begript - zrozumiałe
Bèist - zwierzę
Bethaalen - zapłata
Breuk - złamać
Brokiloéne - z Brokilonu
Caith - zrzucić (zdjąć
Cassve - zważywszy na
Cuir - zatrzymywać się
Cuir - zakładać
Dal - zgrupować
Dei'bai, de'bai - zatoka
Dhearmad - zapomnieć
Dolmaach - zachowanie
Erkene - znać
Erkene - znać się
Eveigh - zawsze
Faight - znaleźć
Faill - znowu
Fallain - zdrowie
Fallain - zdrowy
Geas - zew
Hael - zdrowie
Hav - złe (Aard'hav  najgorsze)
Herba - ziele
Hoael - zadupie
Iare - znaleźć
Il'edrith - zaklęcie
Imbael - zapładniać
Inváerne - zima
Midinváerne - zimowe przesilenie
Mire - zobaczyć
Namyn - z wyjątkiem
Òrde - zreth
Pa’as - zadbać
Pest - zaraza
Pest - zły urok
Pesta - zachorować
Pestaë - zarażony
Qinnte - z pewnością
Ragah - zarośnięty
Ro - zanim
Saoil - zdziwiony
Se'ege - zwycięstwo
Seo - znaczy
Thaess, Thaesse - zamilcz
Thaess, Thaesse - zamknij się
Tolla - znudzenie
Tuvean, Tuv'en, Tuve’an - zabić
Uniade - związek
Va, Ve (forma Ve jest stosowana rzadko i głównie w dialekcie nilfgaardzkim) - zachowywać się
Vaer'trouv - zawierzyć
Vaer'trouv - zaufać (komuś)
Vedrai - zatrzymać
Vermogen - zdolność
Versla - zgłaszać się
Voe'rle - zatrzymać
Voot - za